WE    ./textures/tile006.xpm
SO ./textures/tile005.xpm
EA ./textures/tile007.xpm
NO  ./textures/tile003.xpm

C 120,249,241
F 249,120,165

        1111111111111111111111111
        1000000000110000000000001
        1011000001110000000000001
        1001000000000000000W00001
111111111011000001110000000000001
100000000011000001110111111111111
11110111111111011100000010001
11110111111111011101010010001
11000000110111011100000010001
10000000000000001100000100011
10000000000000001101010010001
110000011101010111110111100111
11110111 1110101 101111010001
11111111 1111111 111111111111

