WE ./textures/tile006.xpm
SO     ./textures/tile005.xpm
EA    ./textures/tile007.xpm
NO     ./textures/tile003.xpm



C      130,224,170
F 123,45,66


1111111111111111
1010100000010101
10101000S0010101
101010000001010111111111
100000000000000000000001
111111000001111111111111
1000000000000001
1111110000011111
1000000000000001
1000000000000001
1111111111111111
