
NO                 ./textures/tile003.xpm
WE ./textures/tile006.xpm
SO ./textures/tile005.xpm
EA ./textures/tile007.xpm

C 130,004,170
F  005,30,0


111111111
100000001
100000001
100000001
100000001
1N0000001
100000001
100000001
100000001
111111111